{
    "id": 2,
    "maps": [
        {
            "index": 0,
            "name": "Mappa 0",
            "rooms": [
                "11111111111100000000000000000000000000000000000000",
                "11111111111100000000000000000000000000000000000000",
                "11111111110100000000000000000000000000000000000000",
                "11110111111100000000000000000000000000000000000000",
                "11111111111110000000000000000000000000000000000000",
                "11111111111100000000000000000000000000000000000000",
                "10111111101100000000000000000000000000000000000000",
                "11111111111100000000000000000000000000000000000000",
                "11011111111100000000000000000000000000000000000000",
                "11111100111100000000000000000000000000000000000000",
                "11111000010100000000000000000000000000000000000000",
                "10111000011100000000000000000000000000000000000000",
                "11111111111100000000000000000000000000000000000000",
                "00000000000000000000000000000000000000000000000000",
                "00000000000000000000000000000000000000000000000000",
                "00000000000000000000000000000000000000000000000000",
                "00000000000000000000000000000000000000000000000000",
                "00000000000000000000000000000000000000000000000000",
                "00000000000000000000000000000000000000000000000000",
                "00000000000000000000000000000000000000000000000000",
                "00000000000000000000000000000000000000000000000000",
                "00000000000000000000000000000000000000000000000000",
                "00000000000000000000000000000000000000000000000000",
                "00000000000000000000000000000000000000000000000000",
                "00000000000000000000000000000000000000000000000000",
                "00000000000000000000000000000000000000000000000000",
                "00000000000000000000000000000000000000000000000000",
                "00000000000000000000000000000000000000000000000000",
                "00000000000000000000000000000000000000000000000000",
                "00000000000000000000000000000000000000000000000000",
                "00000000000000000000000000000000000000000000000000",
                "00000000000000000000000000000000000000000000000000",
                "00000000000000000000000000000000000000000000000000",
                "00000000000000000000000000000000000000000000000000",
                "00000000000000000000000000000000000000000000000000",
                "00000000000000000000000000000000000000000000000000",
                "00000000000000000000000000000000000000000000000000",
                "00000000000000000000000000000000000000000000000000",
                "00000000000000000000000000000000000000000000000000",
                "00000000000000000000000000000000000000000000000000",
                "00000000000000000000000000000000000000000000000000",
                "00000000000000000000000000000000000000000000000000",
                "00000000000000000000000000000000000000000000000000",
                "00000000000000000000000000000000000000000000000000",
                "00000000000000000000000000000000000000000000000000",
                "00000000000000000000000000000000000000000000000000",
                "00000000000000000000000000000000000000000000000000",
                "00000000000000000000000000000000000000000000000000",
                "00000000000000000000000000000000000000000000000000",
                "00000000000000000000000000000000000000000000000000"
            ]
        },
        {
            "index": 1,
            "name": "Mappa 1",
            "rooms": [
                "01111111100000000000000000000000000000000000000000",
                "01111111100000000000000000000000000000000000000000",
                "01101111100000000000000000000000000000000000000000",
                "11111111100000000000000000000000000000000000000000",
                "01111111100000000000000000000000000000000000000000",
                "01111101100000000000000000000000000000000000000000",
                "01110111100000000000000000000000000000000000000000",
                "01111111100000000000000000000000000000000000000000",
                "00000000000000000000000000000000000000000000000000",
                "00000000000000000000000000000000000000000000000000",
                "00000000000000000000000000000000000000000000000000",
                "00000000000000000000000000000000000000000000000000",
                "00000000000000000000000000000000000000000000000000",
                "00000000000000000000000000000000000000000000000000",
                "00000000000000000000000000000000000000000000000000",
                "00000000000000000000000000000000000000000000000000",
                "00000000000000000000000000000000000000000000000000",
                "00000000000000000000000000000000000000000000000000",
                "00000000000000000000000000000000000000000000000000",
                "00000000000000000000000000000000000000000000000000",
                "00000000000000000000000000000000000000000000000000",
                "00000000000000000000000000000000000000000000000000",
                "00000000000000000000000000000000000000000000000000",
                "00000000000000000000000000000000000000000000000000",
                "00000000000000000000000000000000000000000000000000",
                "00000000000000000000000000000000000000000000000000",
                "00000000000000000000000000000000000000000000000000",
                "00000000000000000000000000000000000000000000000000",
                "00000000000000000000000000000000000000000000000000",
                "00000000000000000000000000000000000000000000000000",
                "00000000000000000000000000000000000000000000000000",
                "00000000000000000000000000000000000000000000000000",
                "00000000000000000000000000000000000000000000000000",
                "00000000000000000000000000000000000000000000000000",
                "00000000000000000000000000000000000000000000000000",
                "00000000000000000000000000000000000000000000000000",
                "00000000000000000000000000000000000000000000000000",
                "00000000000000000000000000000000000000000000000000",
                "00000000000000000000000000000000000000000000000000",
                "00000000000000000000000000000000000000000000000000",
                "00000000000000000000000000000000000000000000000000",
                "00000000000000000000000000000000000000000000000000",
                "00000000000000000000000000000000000000000000000000",
                "00000000000000000000000000000000000000000000000000",
                "00000000000000000000000000000000000000000000000000",
                "00000000000000000000000000000000000000000000000000",
                "00000000000000000000000000000000000000000000000000",
                "00000000000000000000000000000000000000000000000000",
                "00000000000000000000000000000000000000000000000000",
                "00000000000000000000000000000000000000000000000000"
            ]
        },
        {
            "index": 2,
            "name": "Casa",
            "rooms": [
                "00000000000000000000000000000000000000000000000000",
                "00000000000000000000000000000000000000000000000000",
                "00000000000000000000000000000000000000000000000000",
                "00000000000000000000000000000000000000000000000000",
                "00000001100000000000000000000000000000000000000000",
                "00000011110000000000000000000000000000000000000000",
                "00000011110000000000000000000000000000000000000000",
                "00000000000000000000000000000000000000000000000000",
                "00000000000000000000000000000000000000000000000000",
                "00000000000000000000000000000000000000000000000000",
                "00000000000000000000000000000000000000000000000000",
                "00000000000000000000000000000000000000000000000000",
                "00000000000000000000000000000000000000000000000000",
                "00000000000000000000000000000000000000000000000000",
                "00000000000000000000000000000000000000000000000000",
                "00000000000000000000000000000000000000000000000000",
                "00000000000000000000000000000000000000000000000000",
                "00000000000000000000000000000000000000000000000000",
                "00000000000000000000000000000000000000000000000000",
                "00000000000000000000000000000000000000000000000000",
                "00000000000000000000000000000000000000000000000000",
                "00000000000000000000000000000000000000000000000000",
                "00000000000000000000000000000000000000000000000000",
                "00000000000000000000000000000000000000000000000000",
                "00000000000000000000000000000000000000000000000000",
                "00000000000000000000000000000000000000000000000000",
                "00000000000000000000000000000000000000000000000000",
                "00000000000000000000000000000000000000000000000000",
                "00000000000000000000000000000000000000000000000000",
                "00000000000000000000000000000000000000000000000000",
                "00000000000000000000000000000000000000000000000000",
                "00000000000000000000000000000000000000000000000000",
                "00000000000000000000000000000000000000000000000000",
                "00000000000000000000000000000000000000000000000000",
                "00000000000000000000000000000000000000000000000000",
                "00000000000000000000000000000000000000000000000000",
                "00000000000000000000000000000000000000000000000000",
                "00000000000000000000000000000000000000000000000000",
                "00000000000000000000000000000000000000000000000000",
                "00000000000000000000000000000000000000000000000000",
                "00000000000000000000000000000000000000000000000000",
                "00000000000000000000000000000000000000000000000000",
                "00000000000000000000000000000000000000000000000000",
                "00000000000000000000000000000000000000000000000000",
                "00000000000000000000000000000000000000000000000000",
                "00000000000000000000000000000000000000000000000000",
                "00000000000000000000000000000000000000000000000000",
                "00000000000000000000000000000000000000000000000000",
                "00000000000000000000000000000000000000000000000000",
                "00000000000000000000000000000000000000000000000000"
            ]
        }
    ],
    "name": "Nuova",
    "rooms": [
        {
            "exitE": {
                "code": "{283b57f4-3484-4c57-ac9d-4cb6c10a9cec}"
            },
            "name": "",
            "roomCoord": [
                12,
                4,
                0
            ]
        },
        {
            "exitS": {
                "closeAction": "close",
                "code": "{5d06a8ef-a80f-4e51-953b-66614ff84bb2}",
                "door": "porta",
                "openAction": "open"
            },
            "name": "",
            "roomCoord": [
                6,
                8,
                0
            ]
        },
        {
            "exitN": {
                "closeAction": "close",
                "code": "{5d06a8ef-a80f-4e51-953b-66614ff84bb2}",
                "door": "porta",
                "openAction": "open"
            },
            "name": "",
            "roomCoord": [
                7,
                4,
                2
            ]
        }
    ]
}
